..............................
..............................
..............................
..............................
..............................
..............................
..............................
..........rrrrrrrrrs..........
.........#############........
..............................
.....g........................
....###.................###...
..............................
............................X.
##############################