..............................
..............................
..............................
..............................
..............................
..............................
..............................
..............................
.........#############........
..............................
.....pk.......................
....####................###...
..............................
...........q.......s........X.
##############################