..............................
..............................
..............................
..............................
..............................
..............................
..............................
..............................
.........#############........
..............................
..............................
....###.................###...
..............................
.1..........................X.
##############################