#...#..##..#..#....#...#.#.#...#
.#.#..#..#.#..#....#...#.#.##..#
..#...#..#.#..#....#.#.#.#.#.#.#
..#...#..#.#..#....#.#.#.#.#..##
..#....##...##......#.#..#.#...#
................................
................p...............
################################