..............................
..............................
..............................
..............................
..............................
..............................
..............................
..........q........s..........
.........#############........
..............................
.....pr.......................
....####................###...
..............................
............................X.
##############################