..............................
..............................
..............................
..............................
..............................
..............................
..............................
..........r........s..........
.........#############........
..............................
.....gq.......................
....####................###...
..............................
............................X.
##############################