..............................
..............................
....-----....-----.......-----
..............................
..............................
..............................
............................x.
....#####....#####.......#####
....#####....#####.......#####
....#####....#####.......#####
p.o.#####....#####.......#####
###########..#######.....#####
######################...#####
##############################
##############################